0,0,0f3,0,3f9,1,1
1,0,1f3,1,4f4,0,3
3,2,3f8,0,0f9,1,0
1,1,5f3,2,0f9,2,0
3,0,0f5,0,0f9,0,0
3,1,3f4,0,3f9,3,0
1,0,4f2,1,1f4,0,0
7,0,0f8,1,0f9,3,0
7,2,3f8,1,0f9,2,0
4,1,1f6,1,1f8,0,3