2,0,0f3,0,0f4,0,3f5,0,1
1,0,3f2,1,0f6,1,1f8,3,0
2,0,3f3,1,1f5,0,0f8,2,0
0,0,2f1,0,0f4,0,6f9,3,1
1,0,4f2,1,0f4,0,6f6,0,0
1,0,1f6,2,3f7,1,0f8,1,1
1,0,0f3,0,1f4,1,1f8,0,3
5,0,0f6,0,3f7,3,1f8,3,1
0,0,2f1,0,3f4,1,0f6,0,0
1,0,0f2,0,0f3,0,4f5,0,3