0,0,6f4,1,1f7,1,1f8,3,0f9,0,0
0,0,2f3,1,3f6,0,0f7,2,3f8,2,3
1,0,1f2,0,0f6,2,0f7,2,0f9,3,0
3,0,0f6,2,3f7,3,0f8,3,1f9,0,3
3,1,1f6,0,0f7,2,0f8,2,3f9,2,0
1,0,4f2,0,0f4,1,2f5,0,3f6,1,1
0,0,1f3,0,1f4,1,0f7,0,3f9,2,0
2,1,4f6,2,0f7,2,3f8,1,0f9,1,0
3,0,0f4,0,0f5,0,1f6,1,1f9,0,3
0,0,0f2,0,1f3,0,1f6,1,1f7,1,0