3,1,3f4,1,2f6,1,0f7,2,0f8,3,1f9,3,0
2,0,0f4,0,6f6,3,1f7,2,3f8,2,0f9,3,0
1,0,0f3,0,3f4,1,2f6,3,1f7,3,1f8,1,0
0,0,6f4,1,0f6,1,1f7,1,0f8,3,0f9,3,0
3,0,0f4,0,3f5,0,1f6,3,0f7,2,3f8,1,0
1,0,1f2,1,3f3,0,0f6,0,3f7,1,0f9,2,0
3,0,0f5,0,1f6,1,1f7,2,0f8,1,0f9,1,1
2,0,0f4,0,0f6,0,3f7,2,0f8,2,0f9,3,0
2,0,1f4,1,2f6,2,0f7,3,0f8,3,1f9,0,3
1,0,0f4,0,6f5,0,3f6,2,3f7,1,0f9,2,3